"a" = (/turf/unsimulated/beach/sand,/area/awaymission/beach)
"b" = (/turf/unsimulated/beach/sand{density = 1; opacity = 1},/area/awaymission/beach)
"c" = (/turf/space,/area/shuttle/mining/outpost)
"d" = (/obj/effect/overlay/palmtree_r,/turf/unsimulated/beach/sand,/area/awaymission/beach)
"e" = (/turf/unsimulated/wall{tag = "icon-sandstone6"; icon_state = "sandstone6"},/area/awaymission/beach)
"f" = (/turf/unsimulated/wall{tag = "icon-sandstone12"; icon_state = "sandstone12"},/area/awaymission/beach)
"g" = (/turf/unsimulated/wall{tag = "icon-sandstone10"; icon_state = "sandstone10"},/area/awaymission/beach)
"h" = (/obj/structure/closet/athletic_mixed,/turf/unsimulated/beach/sand,/area/awaymission/beach)
"i" = (/obj/item/clothing/shoes/sandal,/obj/item/clothing/shoes/sandal,/obj/item/clothing/shoes/sandal,/obj/structure/closet/crate,/turf/unsimulated/beach/sand,/area/awaymission/beach)
"j" = (/turf/unsimulated/wall{tag = "icon-sandstone3"; icon_state = "sandstone3"},/area/awaymission/beach)
"k" = (/obj/structure/closet/gmcloset{icon_closed = "black"; icon_state = "black"; name = "formal wardrobe"},/turf/unsimulated/floor{tag = "icon-wood"; icon_state = "wood"},/area/awaymission/beach)
"l" = (/obj/structure/closet/secure_closet/bar,/turf/unsimulated/floor{tag = "icon-wood"; icon_state = "wood"},/area/awaymission/beach)
"m" = (/obj/structure/table/woodentable,/obj/item/weapon/book/manual/barman_recipes,/turf/unsimulated/floor{tag = "icon-wood"; icon_state = "wood"},/area/awaymission/beach)
"n" = (/obj/structure/table/woodentable,/obj/item/weapon/reagent_containers/food/drinks/shaker,/turf/unsimulated/floor{tag = "icon-wood"; icon_state = "wood"},/area/awaymission/beach)
"o" = (/obj/structure/table/woodentable,/turf/unsimulated/floor{tag = "icon-wood"; icon_state = "wood"},/area/awaymission/beach)
"p" = (/obj/structure/table/woodentable,/obj/item/clothing/glasses/sunglasses,/turf/unsimulated/floor{tag = "icon-wood"; icon_state = "wood"},/area/awaymission/beach)
"q" = (/obj/machinery/vending/boozeomat{emagged = 1},/turf/unsimulated/floor{tag = "icon-wood"; icon_state = "wood"},/area/awaymission/beach)
"r" = (/obj/machinery/vending/cigarette,/turf/unsimulated/floor{tag = "icon-wood"; icon_state = "wood"},/area/awaymission/beach)
"s" = (/obj/machinery/vending/cola,/turf/unsimulated/floor{tag = "icon-wood"; icon_state = "wood"},/area/awaymission/beach)
"t" = (/obj/machinery/vending/snack,/turf/unsimulated/floor{tag = "icon-wood"; icon_state = "wood"},/area/awaymission/beach)
"u" = (/turf/unsimulated/wall{tag = "icon-sandstone1"; icon_state = "sandstone1"},/area/awaymission/beach)
"v" = (/turf/unsimulated/floor{tag = "icon-wood"; icon_state = "wood"},/area/awaymission/beach)
"w" = (/obj/structure/mineral_door/wood{tag = "icon-wood"; icon_state = "wood"},/turf/unsimulated/floor{tag = "icon-wood"; icon_state = "wood"},/area/awaymission/beach)
"x" = (/obj/effect/overlay/palmtree_l,/turf/unsimulated/beach/sand,/area/awaymission/beach)
"y" = (/turf/unsimulated/wall{tag = "icon-sandstone0"; icon_state = "sandstone0"},/area/awaymission/beach)
"z" = (/obj/item/weapon/beach_ball,/turf/unsimulated/beach/sand,/area/awaymission/beach)
"A" = (/obj/structure/stool,/turf/unsimulated/beach/sand,/area/awaymission/beach)
"B" = (/mob/living/simple_animal/crab/Coffee,/turf/unsimulated/beach/sand,/area/awaymission/beach)
"C" = (/obj/effect/overlay/coconut,/turf/unsimulated/beach/sand,/area/awaymission/beach)
"D" = (/obj/structure/stool/bed/chair,/turf/unsimulated/beach/sand,/area/awaymission/beach)
"E" = (/turf/unsimulated/beach/coastline{density = 1; opacity = 1},/area/awaymission/beach)
"F" = (/turf/unsimulated/beach/coastline,/area/awaymission/beach)
"G" = (/turf/unsimulated/beach/water{density = 1; opacity = 1},/area/awaymission/beach)
"H" = (/turf/unsimulated/beach/water,/area/awaymission/beach)

(1,1,1) = {"
aaaaaaaaaabbbbbbbbbbbbbbbbbbbbbbbbbbbbbb
acccccccccccaaaaaaaaaaaaaaaaaaaaaaaaadab
acccccccccccaaaaaaaaaaaaaaaaaaaaaaaaaaab
accccccccccceffffffffffgaahihihihihihihb
acccccccccccjklmnopqrstjaaaaaaaaaaaaaaab
acccccccccccuvvvvvvvvvvjaaaaaaaaaaaaaaab
acccccccccccwvvvvvvvvvvjaaaaaaaaaxaaaaab
acccccccccccyoooooooooouaaaxaazaaaaaaaab
acccccccccccaAAAAAAAAAAaaaaaaaaaaaaaaaab
acccccccccccaaaaaaaaaaaaaaaaaaaaaaaaaaab
acccccccccccaaaaaaaaaaaaaaaaaaadaaaaaaab
acccccccccccaaaaaaaaaaxaaaaaBaaaCaaaaadb
acccccccccccaDaDaDaDaDaDaaaaaaaaaaDaDaab
bcccccccccccaaaaaaaaaaaaaaaaaaaaaaaaaaab
EcccccccccccFFFFFFFFFFFFFFFFFFFFFFFFFFFE
GcccccccccccHHHHHHHHHHHHHHHHHHHHHHHHHHHG
GcccccccccccHHHHHHHHHHHHHHHHHHHHHHHHHHHG
GcccccccccccHHHHHHHHHHHHHHHHHHHHHHHHHHHG
GcccccccccccHHHHHHHHHHHHHHHHHHHHHHHHHHHG
GcccccccccccHHHHHHHHHHHHHHHHHHHHHHHHHHHG
GHHHHHHHHHHHHHHHHHHHHHHHHHHHHHHHHHHHHHHG
GHHHHHHHHHHHHHHHHHHHHHHHHHHHHHHHHHHHHHHG
GHHHHHHHHHHHHHHHHHHHHHHHHHHHHHHHHHHHHHHG
GHHHHHHHHHHHHHHHHHHHHHHHHHHHHHHHHHHHHHHG
GGGGGGGGGGGGGGGGGGGGGGGGGGGGGGGGGGGGGGGG
"}
