"a" = (/turf/simulated/mineral,/area)
"b" = (/turf/simulated/floor/plating/airless/asteroid,/area/mine/unexplored)
"c" = (/turf/simulated/mineral,/area/mine/unexplored)
"d" = (/turf/space,/area)
"e" = (/turf/simulated/wall/r_wall,/area/awaymission/listeningpost)
"f" = (/turf/simulated/floor/plating,/area/awaymission/listeningpost)
"g" = (/obj/machinery/power/smes/magical{desc = "A high-capacity superconducting magnetic energy storage (SMES) unit."; name = "power storage unit"},/turf/simulated/floor/plating,/area/awaymission/listeningpost)
"h" = (/obj/machinery/door/airlock,/turf/simulated/floor,/area/awaymission/listeningpost)
"i" = (/turf/simulated/wall,/area/awaymission/listeningpost)
"j" = (/turf/simulated/floor/plating/airless/asteroid,/area)
"k" = (/obj/structure/table,/obj/item/weapon/paper/monitorkey,/obj/item/device/radio/intercom{desc = "Talk through this. Evilly"; freerange = 1; frequency = 1213; name = "Syndicate Intercom"; pixel_x = 32; subspace_transmission = 1; syndie = 1},/obj/item/clothing/glasses/regular,/turf/simulated/floor,/area/awaymission/listeningpost)
"l" = (/obj/structure/table,/turf/simulated/floor,/area/awaymission/listeningpost)
"m" = (/turf/simulated/floor,/area/awaymission/listeningpost)
"n" = (/obj/machinery/door/airlock/external,/turf/simulated/floor/plating,/area/awaymission/listeningpost)
"o" = (/obj/machinery/computer/message_monitor,/turf/simulated/floor,/area/awaymission/listeningpost)
"p" = (/obj/structure/stool/bed/chair{dir = 4},/mob/living/simple_animal/hostile/syndicate{desc = "A weary looking syndicate operative."; faction = "syndicate"},/turf/simulated/floor,/area/awaymission/listeningpost)
"q" = (/obj/structure/table,/obj/item/weapon/paper{info = "Nothing of interest to report."; name = "november report"},/obj/item/weapon/pen,/turf/simulated/floor,/area/awaymission/listeningpost)
"r" = (/obj/item/device/radio/intercom{desc = "Talk through this. Evilly"; freerange = 1; frequency = 1213; name = "Syndicate Intercom"; pixel_x = 32; subspace_transmission = 1; syndie = 1},/turf/simulated/floor,/area/awaymission/listeningpost)
"s" = (/obj/structure/rack,/obj/item/clothing/suit/space/syndicate,/obj/item/clothing/mask/gas,/obj/item/clothing/head/helmet/space/syndicate,/turf/simulated/floor,/area/awaymission/listeningpost)
"t" = (/obj/machinery/door/airlock,/obj/item/weapon/paper{info = "I wonder how much longer they will accept my empty reports. They will cancel the case  soon without results.  When the pickup comes, I will tell them I have lost faith in our cause, and beg them to consider a diplomatic solution. How many nuclear teams have been dispatched with those nukes? I must try and prevent more from ever being sent. If they will not listen to reason, I will detonate the warehouse myself. Maybe some day in the immediate future, space will be peaceful, though I don't intend to live to see it. And that is why I write this down- it is my sacrifice that stabilised your worlds, traveller. Spare a thought for me, and please attempt to prevent nuclear proliferation, should it ever rear it's ugly head again. -Donk Co. Operative #451"; name = "odd report"},/obj/item/weapon/gun/projectile/pistol,/obj/item/weapon/silencer,/turf/simulated/floor,/area/awaymission/listeningpost)
"u" = (/obj/structure/disposalpipe/segment{dir = 4; icon_state = "pipe-c"},/turf/simulated/mineral,/area/mine/unexplored)
"v" = (/obj/structure/disposalpipe/segment{dir = 4},/turf/simulated/mineral,/area/mine/unexplored)
"w" = (/obj/structure/disposaloutlet{dir = 4},/obj/structure/disposalpipe/trunk{dir = 8},/turf/simulated/floor/plating/airless,/area)
"x" = (/obj/structure/stool/bed,/obj/item/weapon/bedsheet/brown,/turf/simulated/floor,/area/awaymission/listeningpost)
"y" = (/obj/structure/table,/obj/item/device/flashlight/lamp,/turf/simulated/floor,/area/awaymission/listeningpost)
"z" = (/obj/machinery/vending/snack,/turf/simulated/floor,/area/awaymission/listeningpost)
"A" = (/obj/structure/disposalpipe/segment,/turf/simulated/mineral,/area/mine/unexplored)
"B" = (/obj/machinery/vending/cola,/turf/simulated/floor,/area/awaymission/listeningpost)
"C" = (/obj/structure/closet,/obj/item/clothing/gloves/boxing,/turf/simulated/floor,/area/awaymission/listeningpost)
"D" = (/obj/structure/filingcabinet,/obj/item/weapon/paper{info = "A good start to the operation: intercepted Nanotrasen military communications. A convoy is scheduled to transfer nuclear warheads to a new military base. This is as good a chance as any to get our hands on some heavy weaponry, I suggest we take it."; name = "april report"},/obj/item/weapon/paper{info = "Nothing of real interest to report this month. I have intercepted faint transmissions from what appears to be some sort of pirate radio station. They do not appear to be relevant to my assignment."; name = "may report"},/obj/item/weapon/paper{info = "Nanotrasen communications have been noticably less frequent recently.  The pirate radio station I found last month has been transmitting pro-Nanotrasen propaganda. I will continue to monitor it."; name = "june report"},/obj/item/weapon/paper{info = "Nothing of interest to report."; name = "july report"},/obj/item/weapon/paper{info = "Nothing of interest to report."; name = "august report"},/obj/item/weapon/paper{info = "Nothing of interest to report."; name = "september report"},/obj/item/weapon/paper{info = "Nothing of interest to report."; name = "october report"},/obj/item/weapon/paper{info = "1 x Stechtkin pistol - $600<br>1 x silencer - $200<br>shipping charge - $4360<br>total - $5160"; name = "receipt"},/turf/simulated/floor,/area/awaymission/listeningpost)
"E" = (/obj/structure/table,/obj/item/weapon/paper{info = "<b>Mission Details</b>: You have been assigned to a newly constructed listening post constructed within an asteroid in Nanotrasen space to monitor their plasma mining operations. Accurate intel is crucial to the success of our operatives onboard, do not fail us."; name = "mission briefing"},/turf/simulated/floor,/area/awaymission/listeningpost)
"F" = (/obj/machinery/disposal,/obj/structure/disposalpipe/trunk{dir = 4},/turf/simulated/floor,/area/awaymission/listeningpost)
"G" = (/obj/structure/disposalpipe/segment{dir = 4},/turf/simulated/wall/r_wall,/area/awaymission/listeningpost)
"H" = (/obj/structure/disposalpipe/segment{dir = 8; icon_state = "pipe-c"},/turf/simulated/mineral,/area/mine/unexplored)
"I" = (/turf/space,/area/mine/unexplored)
"J" = (/obj/machinery/door/airlock{name = "Toilet"},/turf/simulated/floor,/area/awaymission/listeningpost)
"K" = (/turf/simulated/floor{icon_state = "freezerfloor"},/area/awaymission/listeningpost)
"L" = (/obj/machinery/shower{tag = "icon-shower (WEST)"; icon_state = "shower"; dir = 8},/turf/simulated/floor{icon_state = "freezerfloor"},/area/awaymission/listeningpost)
"M" = (/obj/structure/toilet{tag = "icon-toilet00 (WEST)"; icon_state = "toilet00"; dir = 8},/turf/simulated/floor{icon_state = "freezerfloor"},/area/awaymission/listeningpost)
"N" = (/turf/simulated/mineral/random,/area/mine/unexplored)

(1,1,1) = {"
aaaaabbccccccccadddd
aabcccccccccccccaddd
abcccccceeeecccccddd
bbccccccefgecccccddd
cccccceeehieeeejdddd
ccccceeklmmnffnjdddd
ccccceopqmmnffnjdddd
ccccceerlmmeeeejdddd
ccccccemmmseccccdddd
ccceeeetiiiecuvvwddd
cccexyimmmzecAcccccc
cccemmhmmmBecAccccbb
ccceCDiEmFGGvHccccbI
ccceeeeeJiecccccccbb
ccccccceKLecccccccbj
ccccccceKMeccccccccb
bcccccceeeeccccccccb
bccccccccccccccccccb
bbccccccccNNbddddbNb
dddbdbbbbbbbdddddddd
"}
