"a" = (/turf/simulated/floor/plating/away/grass,/area/awaymission/habit)
"b" = (/turf/unsimulated/beach/water,/area/awaymission/habit)
"c" = (/turf/simulated/mineral,/area/awaymission/habit)
"d" = (/obj/structure/flora/ausbushes/fullgrass,/turf/simulated/floor/plating/away/grass,/area/awaymission/habit)
"e" = (/obj/structure/flora/ausbushes/sparsegrass,/turf/simulated/floor/plating/away/grass,/area/awaymission/habit)
"f" = (/obj/structure/flora/ausbushes/fullgrass,/mob/living/simple_animal/hostile/snake,/turf/simulated/floor/plating/away/grass,/area/awaymission/habit)
"g" = (/obj/structure/flora/ausbushes/reedbush,/turf/simulated/floor/plating/away/grass,/area/awaymission/habit)
"h" = (/mob/living/simple_animal/hostile/giantwasp,/turf/simulated/floor/plating/away/grass,/area/awaymission/habit)

(1,1,1) = {"
aaaaaaaaaaaaaaaaaaaa
aaaaaaaaaaaaaaaaaaaa
aaaaaaaaaaaaaabbaaaa
aaaccdddeeeebbbbaaaa
aaccccddeeeebbbbbaaa
aaccccdfeeaeebbbbaaa
aaecccddeeeeebbbbaaa
aaeccceeeeegebbbbhaa
aaaeeeeeeeegbbbbbaaa
aaaaaeeeaaeebbbbeeea
aaaegaaaeeegabbbbeea
aaaeeeaaeeeaabbbbeea
aabbbeegeeeaabbbbbaa
aabbbbeegeaeaabbbbaa
aabbbbbbeegeeebbbbea
abbbbbbbbbeeebbbbbea
abbbbbbbbbbbbbbbbeea
aabbbbaaaaahaeeeaeea
aaabbaeeeeeeeeeeaaaa
aaaaaaaaaeeeeeeaaaaa
"}
