"aa" = (/turf/space,/area)
"ab" = (/turf/simulated/wall,/area)
"ac" = (/obj/item/weapon/shard,/turf/simulated/floor/plating/airless{broken = 1},/area)
"ad" = (/obj/item/stack/sheet/metal,/turf/simulated/floor/plating/airless{broken = 1},/area)
"ae" = (/obj/item/weapon/shard,/obj/item/stack/rods,/turf/simulated/floor/plating/airless{broken = 1},/area)
"af" = (/obj/structure/grille,/obj/structure/window/reinforced{dir = 1},/obj/structure/window/reinforced{dir = 8},/obj/structure/window/reinforced{dir = 4},/turf/simulated/floor/plating/airless,/area)
"ag" = (/obj/item/weapon/shard,/obj/item/stack/rods,/turf/simulated/floor/airless,/area)
"ah" = (/obj/item/weapon/cable_coil{amount = 2},/obj/effect/decal/cleanable/blood,/turf/simulated/floor/airless{broken = 1},/area)
"ai" = (/obj/item/weapon/stock_parts/console_screen,/turf/simulated/floor/airless{broken = 1},/area)
"aj" = (/obj/item/weapon/shard,/turf/simulated/floor/airless,/area)
"ak" = (/obj/item/stack/sheet/metal,/turf/space,/area)
"al" = (/obj/item/weapon/shard,/turf/space,/area)
"am" = (/obj/structure/grille,/obj/structure/window/reinforced,/obj/structure/window/reinforced{dir = 8},/obj/structure/window/reinforced{dir = 4},/turf/simulated/floor/plating/airless,/area)
"an" = (/obj/structure/computerframe,/turf/simulated/floor/airless,/area)
"ao" = (/obj/item/weapon/shard,/obj/effect/decal/cleanable/blood,/turf/simulated/floor/airless,/area)
"ap" = (/obj/item/stack/rods,/turf/simulated/floor/airless,/area)
"aq" = (/obj/machinery/door/airlock/hatch,/turf/simulated/floor/airless,/area)
"ar" = (/obj/structure/girder,/turf/space,/area)
"as" = (/obj/structure/table,/turf/simulated/floor/wood,/area)
"at" = (/obj/structure/cable{icon_state = "0-4"; d2 = 4},/obj/item/apc_frame,/turf/simulated/floor/airless,/area)
"au" = (/obj/structure/cable{d1 = 2; d2 = 8; icon_state = "2-8"},/obj/structure/cable{d1 = 4; d2 = 8; icon_state = "4-8"},/turf/simulated/floor/airless,/area)
"av" = (/obj/structure/cable{d1 = 2; d2 = 8; icon_state = "2-8"},/obj/effect/decal/cleanable/blood,/turf/simulated/floor/airless,/area)
"aw" = (/turf/simulated/floor/airless,/area)
"ax" = (/obj/structure/closet,/turf/simulated/floor/wood{broken = 1},/area)
"ay" = (/obj/item/weapon/ore/slag,/turf/space,/area)
"az" = (/obj/structure/grille,/obj/structure/window/reinforced{dir = 8},/obj/structure/window/reinforced{dir = 4},/turf/simulated/floor/plating/airless,/area)
"aA" = (/turf/simulated/floor/wood,/area)
"aB" = (/mob/living/simple_animal/hostile/hivebot,/turf/simulated/floor/wood,/area)
"aC" = (/obj/structure/cable{d1 = 1; d2 = 2; icon_state = "1-2"; pixel_y = 0},/turf/simulated/floor/airless,/area)
"aD" = (/obj/structure/cable{d1 = 1; d2 = 2; icon_state = "1-2"; pixel_y = 0},/obj/effect/decal/cleanable/blood,/turf/simulated/floor/airless,/area)
"aE" = (/obj/effect/decal/cleanable/blood,/turf/simulated/floor/airless,/area)
"aF" = (/turf/simulated/floor/wood{broken = 1},/area)
"aG" = (/obj/structure/stool/bed,/obj/item/weapon/bedsheet/red,/turf/simulated/floor/wood,/area)
"aH" = (/obj/machinery/light/small,/turf/simulated/floor/wood,/area)
"aI" = (/obj/structure/closet,/turf/simulated/floor/wood,/area)
"aJ" = (/obj/structure/cable{d1 = 1; d2 = 2; icon_state = "1-2"; pixel_y = 0},/turf/simulated/floor/airless{broken = 1},/area)
"aK" = (/obj/effect/landmark/corpse/engineer,/obj/effect/decal/cleanable/blood,/turf/simulated/floor/airless{broken = 1},/area)
"aL" = (/obj/machinery/light/small,/turf/simulated/floor/wood{broken = 1},/area)
"aM" = (/obj/machinery/light/small{dir = 8},/turf/simulated/floor/airless{broken = 1},/area)
"aN" = (/obj/structure/lattice,/turf/space,/area)
"aO" = (/obj/structure/lattice,/obj/item/weapon/ore/slag,/turf/space,/area)
"aP" = (/obj/item/robot_parts/robot_suit,/obj/item/robot_parts/robot_suit,/obj/structure/closet/crate,/turf/simulated/floor/plating/airless,/area)
"aQ" = (/obj/item/robot_parts/r_leg,/obj/item/robot_parts/r_leg,/obj/structure/closet/crate,/turf/simulated/floor/plating/airless,/area)
"aR" = (/obj/item/robot_parts/r_arm,/obj/item/robot_parts/r_arm,/obj/structure/closet/crate,/obj/machinery/light/small{dir = 1},/turf/simulated/floor/plating/airless,/area)
"aS" = (/obj/item/robot_parts/l_leg,/obj/item/robot_parts/l_leg,/obj/structure/closet/crate,/turf/simulated/floor/plating/airless,/area)
"aT" = (/obj/item/robot_parts/l_arm,/obj/structure/closet/crate,/turf/simulated/floor/plating/airless,/area)
"aU" = (/obj/item/weapon/cable_coil{amount = 2},/turf/space,/area)
"aV" = (/obj/machinery/power/smes,/turf/simulated/floor/plating/airless,/area)
"aW" = (/obj/machinery/light/small{dir = 1},/turf/simulated/floor/plating/airless,/area)
"aX" = (/obj/item/weapon/circuitboard/mecha/ripley/main,/obj/item/weapon/circuitboard/mecha/ripley/peripherals,/obj/structure/closet/crate,/turf/simulated/floor/plating/airless,/area)
"aY" = (/obj/item/mecha_parts/mecha_equipment/tool/cable_layer,/obj/item/mecha_parts/mecha_equipment/tool/cable_layer,/obj/structure/closet/crate,/turf/simulated/floor/plating/airless,/area)
"aZ" = (/obj/item/robot_parts/head,/obj/item/robot_parts/head,/obj/structure/closet/crate,/turf/simulated/floor/plating/airless,/area)
"ba" = (/obj/item/robot_parts/chest,/obj/item/robot_parts/chest,/obj/structure/closet/crate,/turf/simulated/floor/plating/airless,/area)
"bb" = (/turf/simulated/floor/plating/airless,/area)
"bc" = (/turf/simulated/floor/airless{broken = 1},/area)
"bd" = (/obj/structure/cable{icon_state = "0-2"; pixel_y = 1; d2 = 2},/obj/machinery/power/terminal{icon_state = "term"; dir = 1},/turf/simulated/floor/plating/airless,/area)
"be" = (/obj/structure/cable{icon_state = "0-2"; pixel_y = 1; d2 = 2},/obj/machinery/power/terminal{icon_state = "term"; dir = 1},/mob/living/simple_animal/hostile/hivebot,/turf/simulated/floor/plating/airless,/area)
"bf" = (/obj/item/weapon/circuitboard/mecha/odysseus/peripherals,/obj/item/weapon/circuitboard/mecha/odysseus/main,/obj/structure/closet/crate,/turf/simulated/floor/plating/airless,/area)
"bg" = (/obj/item/mecha_parts/mecha_equipment/tool/drill,/obj/item/mecha_parts/mecha_equipment/tool/drill,/obj/structure/closet/crate,/turf/simulated/floor/plating/airless,/area)
"bh" = (/obj/item/robot_parts/robot_component/actuator,/obj/structure/closet/crate,/turf/simulated/floor/plating/airless,/area)
"bi" = (/obj/item/robot_parts/robot_component/armour,/obj/item/robot_parts/robot_component/armour,/obj/structure/closet/crate,/turf/simulated/floor/plating/airless,/area)
"bj" = (/obj/item/robot_parts/robot_component/camera,/turf/simulated/floor/plating/airless,/area)
"bk" = (/turf/simulated/floor/plating/airless{broken = 1},/area)
"bl" = (/obj/machinery/door/airlock/hatch,/turf/simulated/floor/plating/airless,/area)
"bm" = (/obj/structure/cable{d1 = 1; d2 = 4; icon_state = "1-4"},/obj/structure/cable{d1 = 4; d2 = 8; icon_state = "4-8"},/turf/simulated/floor/airless{broken = 1},/area)
"bn" = (/obj/structure/cable{d1 = 4; d2 = 8; icon_state = "4-8"},/turf/simulated/floor/airless,/area)
"bo" = (/obj/machinery/door/airlock/hatch,/obj/structure/cable{d1 = 4; d2 = 8; icon_state = "4-8"},/turf/simulated/floor/plating/airless,/area)
"bp" = (/obj/structure/cable{d1 = 1; d2 = 8; icon_state = "1-8"},/obj/structure/cable{d1 = 4; d2 = 8; icon_state = "4-8"},/turf/simulated/floor/plating/airless,/area)
"bq" = (/obj/structure/cable{d1 = 1; d2 = 8; icon_state = "1-8"},/turf/simulated/floor/plating/airless,/area)
"br" = (/obj/item/weapon/circuitboard/mecha/honker,/obj/item/weapon/circuitboard/mecha/honker/peripherals,/obj/item/weapon/circuitboard/mecha/honker/targeting,/obj/structure/closet/crate,/turf/simulated/floor/plating/airless,/area)
"bs" = (/obj/item/mecha_parts/mecha_equipment/tool/extinguisher,/obj/item/mecha_parts/mecha_equipment/tool/extinguisher,/obj/structure/closet/crate,/turf/simulated/floor/plating/airless,/area)
"bt" = (/obj/item/robot_parts/robot_component/binary_communication_device,/obj/item/robot_parts/robot_component/binary_communication_device,/obj/structure/closet/crate,/turf/simulated/floor/plating/airless,/area)
"bu" = (/obj/item/broken_device,/obj/item/weapon/ore/slag,/turf/simulated/floor/plating/airless,/area)
"bv" = (/mob/living/simple_animal/hostile/hivebot,/turf/simulated/floor/plating/airless,/area)
"bw" = (/obj/item/weapon/circuitboard/mechfab,/obj/structure/closet/crate,/turf/simulated/floor/plating/airless,/area)
"bx" = (/obj/item/mecha_parts/mecha_equipment/tool/hydraulic_clamp,/obj/item/mecha_parts/mecha_equipment/tool/hydraulic_clamp,/obj/structure/closet/crate,/turf/simulated/floor/plating/airless,/area)
"by" = (/obj/structure/girder,/turf/simulated/floor/plating/airless,/area)
"bz" = (/obj/item/mecha_parts/mecha_tracking,/obj/item/mecha_parts/mecha_tracking,/obj/structure/closet/crate,/turf/simulated/floor/plating/airless,/area)
"bA" = (/obj/item/mecha_parts/mecha_equipment/weapon/honker,/obj/item/mecha_parts/mecha_equipment/weapon/honker,/obj/structure/closet/crate,/turf/simulated/floor/plating/airless,/area)
"bB" = (/obj/item/mecha_parts/mecha_equipment/tool/sleeper,/obj/item/mecha_parts/mecha_equipment/tool/sleeper,/obj/structure/closet/crate,/turf/simulated/floor/plating/airless,/area)
"bC" = (/obj/item/robot_parts/robot_component/radio,/obj/item/weapon/ore/slag,/turf/space,/area)
"bD" = (/mob/living/simple_animal/hostile/hivebot/strong,/turf/simulated/floor/plating/airless,/area)
"bE" = (/obj/item/mecha_parts/mecha_equipment/weapon/ballistic/scattershot,/obj/structure/closet/crate,/turf/simulated/floor/plating/airless,/area)
"bF" = (/obj/item/mecha_parts/mecha_equipment/weapon/energy/ion,/obj/structure/closet/crate,/turf/simulated/floor/plating/airless,/area)
"bG" = (/obj/item/mecha_parts/mecha_equipment/weapon/energy/laser,/obj/structure/closet/crate,/turf/simulated/floor/plating/airless,/area)
"bH" = (/obj/item/mecha_parts/mecha_equipment/weapon/energy/taser,/obj/item/mecha_parts/mecha_equipment/weapon/energy/taser,/obj/structure/closet/crate,/turf/simulated/floor/plating/airless,/area)
"bI" = (/obj/item/mecha_parts/mecha_equipment/tool/syringe_gun,/obj/item/mecha_parts/mecha_equipment/tool/syringe_gun,/obj/structure/closet/crate,/turf/simulated/floor/plating/airless,/area)
"bJ" = (/obj/item/mecha_parts/mecha_equipment/weapon/ballistic/lmg,/obj/structure/closet/crate,/turf/simulated/floor/plating/airless,/area)
"bK" = (/obj/item/mecha_parts/mecha_equipment/weapon/ballistic/missile_rack,/obj/structure/closet/crate,/turf/simulated/floor/plating/airless,/area)
"bL" = (/obj/item/mecha_parts/mecha_equipment/weapon/ballistic/missile_rack/flashbang,/obj/structure/closet/crate,/turf/simulated/floor/plating/airless,/area)
"bM" = (/obj/item/mecha_parts/mecha_equipment/weapon/ballistic/missile_rack/flashbang/clusterbang,/obj/structure/closet/crate,/turf/simulated/floor/plating/airless,/area)
"bN" = (/obj/item/mecha_parts/mecha_equipment/tool/rcd,/obj/structure/closet/crate,/turf/simulated/floor/plating/airless,/area)
"bO" = (/obj/structure/grille,/obj/structure/window/reinforced,/obj/structure/window/reinforced{dir = 1},/turf/simulated/floor/plating/airless,/area)
"bP" = (/obj/structure/grille,/obj/structure/window/reinforced,/obj/structure/window/reinforced{dir = 1},/obj/structure/window/reinforced{dir = 4},/turf/simulated/floor/plating/airless,/area)
"bQ" = (/obj/machinery/door/poddoor,/turf/simulated/floor/plating/airless,/area)
"bR" = (/obj/structure/grille,/obj/structure/window/reinforced,/obj/structure/window/reinforced{dir = 1},/obj/structure/window/reinforced{dir = 8},/turf/simulated/floor/plating/airless,/area)
"bS" = (/obj/item/robot_parts/robot_component/diagnosis_unit,/turf/space,/area)
"bT" = (/obj/structure/shuttle/engine/heater,/turf/simulated/floor/plating/airless,/area)
"bU" = (/obj/structure/shuttle/engine/propulsion,/turf/simulated/floor/plating/airless,/area)
"bV" = (/obj/structure/shuttle/engine/propulsion{icon_state = "burst_r"},/turf/simulated/floor/plating/airless,/area)
"bW" = (/obj/structure/shuttle/engine/propulsion{icon_state = "propulsion_l"},/turf/simulated/floor/plating/airless,/area)
"bX" = (/obj/item/robot_parts/robot_component/radio,/turf/space,/area)

(1,1,1) = {"
aaaaaaaaaaaaaaabacacadaeabaaaaaaaaaaaaaa
aaaaaaaaaaaaaaafagahaiajafakaaalaaaaaaaa
aaaaaaaaaaaaaaamanagaoapamaaalaaakaaaaaa
aaaaaaababababababaqaqababarakaaalaaaaaa
aaaaaaafasasasabatauavawabaxaaayazaaaaaa
aaaaaaazaAaBaAaqawaCaDaEaqaaaaaFazaaaaaa
aaaaaaamaGaHaIabawaJaCaKaaaaaLaAamaaaaaa
aaabababababababaMaJaJaNaOababababababaa
aaabaPaQaRaSaTabawaJaUaaabaVaVaWaXaYabaa
aaabaZbabbbbbbabbcaUaUbcabbdbebbbfbgabaa
aaafbhbibbbjbkblaaaNbmbnbobpbqbbbrbsafaa
aaazbtbubkbkbkakakbcawawblbbbbbvbwbxazaa
aaambubkaNayaNbyabblblababbzbAbzbzbBamaa
aaabbkakbCaNaaabbbbbbDbbabbEbFbGbHbIabaa
aaabaaayakaybkabbbbbbbbbabbJbKbLbMbNabaa
aaaaakaabObPabababbQbQabababbRbObObPabaa
aabSaabkbTbTabaaaaaaaaaaaaabbTbTbTbTabaa
aaakaabUbUbVabaaaaaaaaaaaaabbWbUbUbVabaa
akaabXaaaaaaaaaaaaaaaaaaaaaaaaaaaaaaaaaa
aaaaaaaaaaaaaaaaaaaaaaaaaaaaaaaaaaaaaaaa
"}
